111111111111111111111111111111111111111111111111111111111111
100000000000000000000000000000000000000000000000000000011111
100000000000000000000000000000000000000000000000000000011111
100000000000000000000000011111111111111111111111111110011111
110011111111111110011111111111111111111111111111111110011111
110011111111111110011111111111111111111111111111111110011111
111011110000000000000000001111111100000001111111111110011111
110011110000000000000000001111111100000001111111111110011111
100000000011111111111100111111111100000001111111111110000011
111111111111111111111100111111111100000001111111111111100011
111110000000111111111100111111111111001111111111111111100011
111110000000011111111100000000000000000000000000000000000011
111110000000000000000000000000000000000000000000000000000011
111110011110000000000000111111111111111111111111111001111111
111110011111111111111100111111111111111111111111111001111111
111110011111111111111100111111111111111111111111111001111111
111110011111111111111100000000000000000000000000011001111111
111110000000000000000000000000000000000000000000011001111111
111110000000000000000000000000000000000000000000000000011111
111110011111111111111111000000000000000000000000000000011111
111110011111111111111111111111111111111000111111111110011111
111110011111111111111111111111111111111000111111111110011111
111110011111111111111111111111111111111000111111111110011111
111110000000000000000000000000000000000000111111111110011111
111110000000000000000000000000000000000000111111110000001111
111110000000000000000000000000000000000000111111110000001111
111110000000000000000000000000000000000000111111110000001111
111111100000011111111100000111111111111100000000000000001111
111111100000011111111100000111111111111100000000000000011111
111111111111111111111111111111111111111111111111111111111111
